Dungeon 6
bl2.txt
5x5
1
bl3.txt
00Su00Eu0000000000000
0000WuEu0000000000000
0000WuEu0000000000000
00SuWu000000000000000
00Su00Ee0000000000000
NuSu00000000000000000
00Su00Ex0000000000000
000000Eu0000000000000
NuSuWu000000000000000
NuSu00000000000000000
NuSu00000000000000000
Nu0000Eu0000000000000
00SuWu000000000000000
NuSu00000000000000000
NuSu00000000000000000
NuSu00Eu0000000000000
0000Wu000000000000000
Nu0000Eu0000000000000
Nu00Wu000000000000000
NuSu00000000000000000
Nu0000Eu0000000000000
0000WuEu00000rv000000
0000WuEu0000000000000
0000WuEu0000000000000
Nu00Wu000000000000000
