Dungeon 1
al1.txt
3x5
0
al2.txt
Nx0000Eu00000lv000000
0000WuEu01100rb000000
00SuWu0000000lh000000
00Su000000000qv000000
000000000000000000000
NuSl000000000lhlh0000
Nu0000Eu0000000000000
00SuWuEu00000lv000000
Nl00Wu000000000000000
000000000000000000000
NuSu000000000lv000000
000000000000000000000
000000000000000000000
NuSe00000000000000000
000000000000000000000
