Dungeon 2
8996824c8990968f1235822883ff70848f10385b
4x7
0
9dec17ae2ca66e512878dfbf422d1f74d8f6a698
00Su000000000qv000000
000000000000000000000
000000000000000000000
000000000000000000000
NuSu00000010200000000
000000000000000000000
NxSu00000000000000000
000000000000000000000
NuSu00000000000000000
000000000000000000000
NuSl00000000000000000
00Su000000131rb000000
Nu0000Eu020002b000000
0000WuEu0000000000000
NlSuWuEl0000000000000
Nu00Wl000000000000000
000000000000000000000
000000000000000000000
NuSu000002020lhlh0000
000000000000000000000
00Su00EuS00002v000000
0000WuEu0000000000000
Nu00Wu000000000000000
000000000000000000000
NuSe00000000000000000
000000000000000000000
000000000000000000000
000000000000000000000
