Dungeon 3
al3.txt
4x4
0
al4.txt
00Sl00Eu0500000000000
0000Wu0000000rv000000
000000000000000000000
NxSu0000S000000000000
Nl0000Eu0440000lb0000
00SuWu000000000000000
00Sl00El000007v000000
Nu00Wl000330000000000
000000000000000000000
NuSu00Eu0200000000000
NlSuWu0000000lhlv0000
000000000000000000000
000000000000000000000
Nu0000Eu00000qv000000
NpSeWp000000000000000
000000000000000000000
