Dungeon 4
92e5ff567adc98d7e7fc2875342e187aabfa9470
4x5
0
c859a72c54d6e2ef2a16dd5ded40cf3fc9328f3a
000000000000000000000
00Su00Eu0000000000000
0000WuEu0000000000000
00SuWu000000000000000
00Su00Eu0000000000000
Nu00Wu000000000000000
000000000000000000000
Nu0000Ex0000000000000
Nu0000Eu0000000000000
00SuWuEu0000000000000
0000WuEu0000000000000
00SuWu000000000000000
000000000000000000000
Nu0000000000000000000
000000000000000000000
NuSu00000000000000000
000000000000000000000
00Se00Eu0000000000000
0000WuEu0000000000000
Nu00Wu000000000000000
