Dungeon 5
al5.txt
5x4
0
bl1.txt
0000Wu000000000000000
00Su00000000000000000
000000000000000000000
00Su00Eu0000000000000
0000Wu000000000000000
0000WxEu0000000000000
NuSuWuEu0000000000000
0000WuEu0000000000000
NuSuWuEu00000qv000000
0000Wu000000000000000
000000000000000000000
NuSu000000000rv000000
000000000000000000000
NuSu00000000000000000
000000000000000000000
000000Eu0000000000000
Nu00WuEu0000000000000
00SeWuEu0000000000000
Nu00WuEu0000000000000
0000Wu000000000000000
