Dungeon 6
d836397f29852dc098bc813451efaef2844f89f5
5x5
0
7d1c88ea2279a1ea107773acfcd8e8f5f3cf9f8e
00Su00Eu00000000000000000
0000WuEu00000000000000000
0000WuEu00000000000000000
0000WuEu00000000000000000
0000WuEe00000000000000000
NuSu000000000000000000000
0000000000000000000000000
0000000000000000000000000
0000000000000000000000000
0000000000000000000000000
Nu0000Eu00000000000000000
0000WuEu00000000000000000
0000WuEu00000000000000000
00SuWu0000000000000000000
0000000000000000000000000
0000000000000000000000000
0000000000000000000000000
0000000000000000000000000
NuSu00Eu00000000000000000
0000Wu0000000000000000000
0000WxEu00000000000000000
0000WuEu00000000000000000
0000WuEu00000000000000000
Nu00Wu0000000000000000000
0000000000000000000000000
