Dungeon 6
bl1.txt
5x5
1
bl2.txt
00Su00Eu00000qh0000000000
0000WuEu00700000000000000
0000WuEu00000000000000000
0000WpEu00000000000000000
0000WuEe00000000000000000
NuSb000000000000000000000
0000000000000000000000000
0000000000000000000000000
0000000000000000000000000
0000000000000000000000000
Nu0000Eu00800000000000000
0000WuEu00000000000000000
0000WuEu00000000000000000
00SuWu0000880000000000000
0000000000000000000000000
0000000000000000000000000
0000000000000000000000000
0000000000000000000000000
NuSu00Eu00000000000000000
0000Wu000700800rb00000000
0000WxEu00000000000000000
0000WuEu00000000000000000
0000WuEu00000000000000000
Nu00Wu00S0000000000000000
0000000000000000000000000
