Dungeon 6
bl2.txt
5x5
1
bl3.txt
00Su00Eu0000000000000
0000WuEu0800800000000
0000WuEu0000000000000
00SuWu000000000000000
00Su00Ee0000000000000
NuSu00000000000000000
00Su00Ex0000000000000
000000Eu00000rh000000
NuSuWp000000000000000
NuSu000000000lv000000
NuSu00000077000000000
Nu0000Eu0088000000000
00SuWu000000000000000
NuSu00000880800000000
NuSu000000000mv000000
NuSu00Eu0008000000000
0000Wu0000000qv000000
Nu0000Eu0000000000000
Nu00Wu000000000000000
NuSu000000000lv000000
Nu0000Eu0000000000000
0000WuEu0000000000000
0000WuEu0000000000000
0000WuEuS000000000000
Nu00Wu00070873b000000
