Dungeon 6
bl3.txt
4x4
1
bl4.txt
00SuWeEu00000000000000000
00SuWu0000000000000000000
00Sb00Eu00000000000000000
00SuWu0000000000000000000
NuSu00Eu00000000000000000
Nu00Wu0000000rv0000000000
NpSx00Ep00000000000000000
NuSuWb0000000000000000000
NuSu00El00000000000000000
00SlWl0000000qv0000000000
00Sp00Ep00000000000000000
NuSuWp0000000000000000000
Nu0000Eu00000000000000000
Nl00WuEu00000000000000000
Np00WuEu00000000000000000
NuWu000000000000000000000
