Dungeon 6
bl4.txt
5x5
1
bl5.txt
00Su00Eu00000000000000000
0000WuEu00000000000000000
NeSlWuEu00000000000000000
0000WuEu00000000000000000
00SuWu0000000000000000000
NuSu000000000000000000000
0000000000000000000000000
NlSx000000000000000000000
0000000000000000000000000
NuSu000000000000000000000
NuSu00El00000000000000000
0000WlEx00000000000000000
0000000000000000000000000
0000WxEl00000000000000000
NuSuWl0000000000000000000
NuSu000000000000000000000
0000000000000000000000000
NxSl000000000000000000000
0000000000000000000000000
NuSu000000000000000000000
Nu0000Eu00000000000000000
0000WuEu00000000000000000
Nl00WuEu00000000000000000
0000WuEu00000000000000000
NuWu000000000000000000000
