Dungeon 6
bl4.txt
5x5
1
cl1.txt
00Su00Eu00000000000000000
0000WuEu00000000000000000
NeSlWuEu07770000000000000
0000WuEu00000000000000000
00SuWu0000000000000000000
NuSu000000000000000000000
0000000000000000000000000
NlSx0000S0000000000000000
0000000000000000000000000
NuSu000000000000000000000
NuSu00El07870000000000000
0000WlExS0000000000000000
0000000000000000000000000
0000WxElS0000000000000000
NuSuWl0008780000000000000
NuSu000000000000000000000
0000000000000000000000000
NxSl0000S0000000000000000
0000000000000000000000000
NuSu000000000000000000000
Nu0000Eu00000000000000000
0000WuEu00000000000000000
Nl00WuEu08880000000000000
0000WuEu000000000rv000000
NuWu000000000qv0000000000
