Dungeon 1
cl3.txt
10x10
4
cl4.txt
000000000000000000000
000000000000000000000
000000000000000000000
000000000000000000000
000000000000000000000
000000000000000000000
000000000000000000000
000000000000000000000
000000000000000000000
000000000000000000000
00Su000000000rvqv0000
000000000000000000000
000000000000000000000
000000000000000000000
000000000000000000000
000000000000000000000
000000000000000000000
NxSu00000000000000000
000000000000000000000
000000000000000000000
NuSu00000000000000000
000000000000000000000
000000000000000000000
000000000000000000000
000000000000000000000
000000000000000000000
000000000000000000000
Nu0000Eu0000000000000
00SuWuEu0000000000000
00SuWu000000000000000
NuSu00Eu0000000000000
0000Wu000000000000000
000000000000000000000
000000000000000000000
000000000000000000000
000000000000000000000
000000000000000000000
000000000000000000000
NuSu00Ep0000000000000
NpSuWp000000000000000
NuSu00000000000000000
000000000000000000000
000000000000000000000
000000000000000000000
000000000000000000000
000000000000000000000
000000000000000000000
000000000000000000000
NuSu00Ep0000000000000
NpSuWp000000000000000
NuSu00000000000000000
000000000000000000000
000000000000000000000
000000000000000000000
000000000000000000000
000000000000000000000
000000000000000000000
000000000000000000000
NuSu00Ep0000000000000
NpSuWp000000000000000
NuSu00000000000000000
000000000000000000000
000000000000000000000
000000000000000000000
000000000000000000000
000000000000000000000
000000000000000000000
000000000000000000000
NuSu00Ep0000000000000
NpSuWp000000000000000
NuSu00Eu0000000000000
00SuWuEu0000000000000
00SuWu000000000000000
000000000000000000000
000000000000000000000
000000000000000000000
000000000000000000000
000000000000000000000
Nu0000Ep0000000000000
NpSuWu000000000000000
NuSu00Eu0000000000000
NuSuWuEu0000000000000
NuSuWu000000000000000
000000000000000000000
000000000000000000000
000000000000000000000
000000000000000000000
000000000000000000000
000000000000000000000
NuSu00000000000000000
Nu0000Eu0000000000000
Nu00WuEu0000000000000
Nu00WuEu0000000000000
0000WuEu0000000000000
0000WuEu0000000000000
0000WuEu0000000000000
Nx00WuEu0000000000000
0000WuEu0000000000000
0000WuEu0000000000000
Nu00Wu000000000000000

