Dungeon 1
cl4.txt
10x10
4
cl5.txt
000000000000000000000
000000000000000000000
000000000000000000000
000000000000000000000
000000000000000000000
00Su00Eu0000000000000
00SuWuEu0000000000000
0000WuEu0000000000000
00SuWuEu0000000000000
00SuWu000000000000000
000000000000000000000
000000000000000000000
000000000000000000000
000000000000000000000
000000000000000000000
NuSu00Eu0000000000000
NuSuWu000000000000000
000000000000000000000
Nu0000Eu0000000000000
Nu00Wu000000000000000
000000000000000000000
000000000000000000000
000000000000000000000
000000000000000000000
000000000000000000000
Nu0000Eu0000000000000
NuSuWu000000000000000
000000000000000000000
000000000000000000000
000000000000000000000
000000000000000000000
000000000000000000000
000000000000000000000
000000000000000000000
000000000000000000000
000000000000000000000
Nu0000Eu0000000000000
00SuWu000000000000000
000000000000000000000
000000000000000000000
000000000000000000000
000000000000000000000
000000000000000000000
000000000000000000000
000000000000000000000
000000000000000000000
000000000000000000000
NuSu00000000000000000
000000000000000000000
000000000000000000000
000000000000000000000
000000000000000000000
000000000000000000000
000000000000000000000
NxSu00000000000000000
000000000000000000000
000000000000000000000
NuSu00000000000000000
000000000000000000000
000000000000000000000
000000000000000000000
000000000000000000000
000000000000000000000
000000000000000000000
NlSl00Eu0000000000000
0000WuEu0000000000000
0000WuEu0000000000000
NuSuWu000000000000000
000000000000000000000
000000000000000000000
000000000000000000000
000000000000000000000
000000000000000000000
000000000000000000000
Nu00000000000rv000000
000000000000000000000
000000000000000000000
NuSu00000000000000000
000000000000000000000
000000000000000000000
000000000000000000000
000000000000000000000
000000000000000000000
000000000000000000000
000000000000000000000
000000000000000000000
000000000000000000000
Nl0000Eu0000000000000
0000Wu0000000qv000000
000000000000000000000
000000000000000000000
000000000000000000000
000000000000000000000
000000000000000000000
000000000000000000000
000000000000000000000
000000000000000000000
000000000000000000000
000000000000000000000
000000000000000000000
