Dungeon
dl1.txt
5x7
5
dl2.txt
00Su000000000000000qv
0000Wu000000000000000
000000000000000000000
000000000000000000000
000000000000000000000
000000Eu0000000000000
Nu0000000000000000000
0000WuEu0000000000000
00SuWuEu0000000000000
00SuWu000000000000000
000000000000000000000
000000000000000000000
000000000000000000000
Nu0000Eu0000000000000
Nu00Wu000000000000000
000000000000000000000
000000000000000000000
000000000000000000000
000000000000000000000
NuSu00000000000000000
00Su00Eu0000000000000
0000WuEu0000000000000
Ne00WuEu0000000000000
0000WuEu0000000000000
Nu00Wu000000000000000
NuSu00000000000000000
000000Eu000000000rv00
00SpWuEl0000000000000
0000WuEx0000000000000
000000000000000000000
Nu0000Eu0000000000000
0000WuEu0000000000000
Np00Wu000000000000000
000000000000000000000
000000000000000000000
