Dungeon
dl2.txt
7x7
5
dl3.txt
00Su00Eu00000000000rv
00SuWuEu0000000000000
0000WuEu0000000000000
00SuWuEu0000000000000
0000WuEu0000000000000
00SuWuEu0000000000000
00SuWu000000000000000
Nu0000Eu0000000000000
Nu00Wu000000000000000
000000000000000000000
NuSu00000000000000000
000000000000000000000
Nu0000Eu0000000000000
Nu00Wu000000000000000
000000000000000000000
000000000000000000000
000000000000000000000
NuSuWxEx0000000000000
000000000000000000000
000000000000000000000
000000000000000000000
000000000000000000000
000000000000000000000
000000000000000000000
NuSu00000000000000000
000000000000000000000
000000000000000000000
000000000000000000000
00Su000000000000000qv
0000Wu000000000000000
0000WuEu0000000000000
NlSeWuEu0000000000000
0000WuEu0000000000000
000000Eu0000000000000
00Su00000000000000000
00Su00000000000000000
000000000000000000000
Nu0000000000000000000
000000000000000000000
Nu00000000000lv000000
000000000000000000000
00Su0000000001v000000
000000Eu0000000000000
000000Eu0000000000000
Nu0000000000000000000
000000000000000000000
Nu00000000000lv000000
0000Wu000000000000000
0000Wu00000001v000000

