Dungeon
dl3.txt
9x9
5
dl4.txt
00Su00Eu0000000000000
0000WuEu0000000000000
00SuWu000000000000000
000000000000000000000
000000000000000000000
000000000000000000000
00Su00Eu0000000000000
0000WuEu0000000000000
00SuWu000000000000000
NuSu00000000000000000
Nu00WuEu00000qv000000
NuSu00000000000000000
0000Wu000000000000000
0000Wu000000000000000
0000Wu000000000000000
NuSuWu000000000000000
NuSeWuEu0000000000000
NuSu00000000000000000
Nu0000Eu0000000000000
NuSuWuEu0000000000000
Nu00Wu000000000000000
000000000000000000000
000000000000000000000
000000000000000000000
Nu0000Eu0000000000000
NuSuWuEu0000000000000
Nu00Wu000000000000000
000000000000000000000
NuSu00000000000000000
000000000000000000000
000000000000000000000
000000000000000000000
000000000000000000000
000000000000000000000
00Su00000000000000000
000000000000000000000
000000000000000000000
NuSu00000000000000000
000000000000000000000
000000000000000000000
00SuWxEx0000000000000
000000000000000000000
000000000000000000000
00Su00000000000000000
000000000000000000000
000000000000000000000
NuSu00000000000000000
000000000000000000000
000000000000000000000
NlSu00000000000000000
000000000000000000000
000000000000000000000
00Su00000000000000000
000000000000000000000
00Su00Eu0000000000000
Nu00WuEu0000000000000
00SuWu000000000000000
000000000000000000000
NuSu00000000000000000
000000000000000000000
00Su00Eu0000000000000
0000WuEu0000000000000
00SuWu000000000000000
NuSu00000000000000000
Nu00WuEu0000000000000
NuSu00Eu0000000000000
0000WuEu0000000000000
Nu00WuEu0000000000000
0000WuEu0000000000000
NuSu00000000000000000
Nu00WuEu00000rv000000
NuSu00000000000000000
Nu0000Eu0000000000000
Nu00WuEu0000000000000
Nu00Wu000000000000000
000000000000000000000
000000000000000000000
000000000000000000000
Nu0000Eu0000000000000
Nu00WuEu0000000000000
Nu00Wu000000000000000

