Dungeon
dl4.txt
3x5
5
dl5.txt
00Su00000000000000000
000000000000000000000
NeSu00000000000000000
NuSu00000000000000000
000000000000000000000
NuSu00000000000000000
NuSu00000000000000000
000000000000000000000
NuSu00000000000000000
Nu0000Eu0000000000000
0000WuEu0000000000000
Nu00Wu0000000rvqv0000
000000000000000000000
Nx0000000600000000000
000000000000000000000
