Nx0000Eu000001v000000
0000WuEu011003b000000
00SuWu00000001h000000
00Su0000000002v000000
000000000000000000000
NuSl0000000001h1h0000
Nu0000Eu0000000000000
00SuWuEu000001v000000
Nl00Wu000000000000000
000000000000000000000
NuSu0000000001v000000
000000000000000000000
000000000000000000000
NuSe00000000000000000
000000000000000000000
