__E__0000
__EW_0000
__EW_0000
_S_W_0000
_____0000
_____0000
_____0000
NS___0000
_____0000
_S__T0000
_____0000
NS___0000
_____0000
N_E__0000
__EW_0001
NS_W_0000
_____0001
_____0000
_____0000
N____2000
