__E__0001
__EW_0001
__EW_0001
__EW_0001
__EW_0001
___W_0001
