00Su0000000002v000000
000000000000000000000
000000000000000000000
000000000000000000000
NuSu00000010200000000
000000000000000000000
NxSu00000000000000000
000000000000000000000
NuSu00000000000000000
000000000000000000000
NuSl00000000000000000
00Su0000001313b000000
Nu0000Eu020005b000000
0000WuEu0000000000000
NbSuWuEl0000000000000
Nu00Wl000000000000000
000000000000000000000
000000000000000000000
NuSu0000020201h1h0000
000000000000000000000
00Su00EuS00004v000000
0000WuEu0000000000000
Nu00Wu000000000000000
000000000000000000000
NuSe00000000000000000
000000000000000000000
000000000000000000000
000000000000000000000
