00Sl00Eu0500000000000
0000Wu00000003v000000
000000000000000000000
NxSu0000S000000000000
Nl0000Eu04400001b0000
00SuWu000000000000000
00Sl00El000005v000000
Nu00Wl000330000000000
000000000000000000000
NuSu00Eu0200000000000
NlSuWu00000001h1v0000
000000000000000000000
000000000000000000000
Nu0000Eu000002v000000
NpSeWp000000000000000
000000000000000000000
