__E__0000
__EW_0000
_SEWS0001
___W_0011
_____0001
_____0001
_____0001
NS___0000
_____0001
_____0001
_____0001
__E__0001
NSEWS0000
_S_W_0000
_____0001
_____0001
_____0001
NSE__0111
N_EW_0000
_S_W_0000
_____0001
_____0001
N___S0000
_____0001
N___S0011
