__E__0001
__EW_0001
_SEWS0001
___W_0001
_____0001
_____0001
_____0001
NS___0001
_____0001
_____0001
_____0001
__E__0001
NSEW_0001
_S_W_0001
_____0001
_____0001
_____0001
NSE__0001
N_EW_0001
_S_W_0001
_____0001
_____0001
N____0001
_____0001
N___S0001
